4444444444444444444444444444444444444444444444444444444444444444444444444444444
2000000000000000000000000000000000000000000002000000000000000000000000000000000
2000000000000000000000000000000000000000000002000000000000000000000000000000000
2000000000000000################30000000000002000000000000000000000000000000000
20000000000####7##000000000000003000000000000200000000ssssssssssssssssssssssss3
200000###00######00000000000000030000000000002000000000000000000000000000000003
200000###0000000000000000000000030000000000002000000000000000000000000000000003
2000000000000000000000000000000030000000000002sssss0000000000000000000000000003
200000000000000000000000000000003000000000000200000000ssss000000000000000000ss3
2####00000000000000000000000000030000000000002000000000000000000000sss000000003
2#######000####00000000000000#0030000000000002000000000000000000000000000000003
20000###000######00000000000##003000000000000200000000000000sss0000000000000003
200000000000000#####77#00000##0030000000000002000000000000000000000000000000003
2000000000000000000000000000##0030000000000002000000000000000000000000000000003
2000000000000000000000000000##003000000000000200000000ssss000000000000000000003
2000000000000000000000000#####7730000000000002000000000000000000000000000000003
2000000000000000000000000#######300000000000020000uuu00000000000000000000000003
2000000000000000000000000000000030000000000002000000000000000000000000000000003
200000000000######7777##0000000030000000000002000000000sss0000ss0000ss000000003
200000000000############000000003000000000000200000000000000000000000000000sss3
200000000####000000000000000000030000000000002000000000000000000000000000000003
2000000000000000000000000000000030000000000002000000000000000000000000000000003
200000000000000000000000000000003000000000000200000000000000000000000000ss00003
2000000000000000000000000000000030000000000002000000000000000000000000000000003
200000550000000000000000000000003000000000000200000uuuu0000000000000ss000000003
20000000000000000000000000000000300000000000020000000000000000ss000000000000003
2000000000000000000000000000000030000000000002000000000000000000000000000000003
200k000000000555000000000000000030000000000002000000000000000000ss0000000000003
2555557557555005005500000555500030000000000002000000000000000000000000000000003
255555505555500500000005500665003000000000000200000000000000ss00000000000000003
2000000000000005500000050000000030000000000002000000000000000000000000000000003
2000000000000000550055000000000530000000000002000000000000000000000000000000003
2000000000000000055000000000005530000000000002000000dddddd000000000000000000003
2000000000000000000000005500500030000000000002000000000000000000000000000000003
2000000000000000000000055500000030000000000002ssss00000000000000000000000000003
2000000000000500000000550000000030000000000002ssss00000000000000000000000000003
200000000000f55000005000000000003000000000000200000000r000000000000000000000003
200000055577555555570000566666663000000000000200000sssssss000000sssss0000000003
2000000555555000000000008000000030000000000002000000000000000000000000000000003
2000055550000000000000008000000c30000000000002000000000000000000000000000000003
20000556600000000000000080055555300000000000020000000000000000000000000ssuuuuu3
25500000000000000550000080000000300000000000020000000000000000000000000sssssss3
2550000000000000055000000500000030000000000002000000000000000000000000000000003
200580000055000575550000006500003000000000000200000uuuus00000000ssss00000000003
2005800005555005555580000000005530000000000002000000000000000000ssss00000000003
2000055500000000000555500000050030000000000002000000000000000000000000000000003
2000055550000000000555500000500030000000000002000000000000sssss0000000000000003
2000000000000000000005555000000030000000000002000000000000sssss0000000000000003
2000000000000000000005555000000030000000000002000000000000000000000000000000003
2000000000555775500009555550000530000000000002000000000000000000000000000000003
2000000005555555500009555550000530000000000002000000sssss0000000000000000000003
2000000055555555555000000000055530000000000000000000000000000000000000000000003
2000000555555555555000000000f55530000000000000000000000000000000000000000000003
1111111111111111111111111111111111111111111111111111111111111111111111111111111